vk=vk.com
ok=ok.ru
wa=Whatsapp
vi=Viber
tg=Telegram
wb=WeChat
go=Google,youtube,Gmail
av=avito
av=avito call forwarding
fb=facebook
tw=Twitter
ot=Any other call forwarding
ub=Uber
qw=Qiwi
gt=Gett
sn=OLX
ig=Instagram
ss=hezzl
ym=youla.ru
ym=youla.ru call forwarding
ma=Mail.ru
mm=Microsoft
uk=Airbnb
me=Line messenger
mb=Yahoo
we=DrugVokrug
bd=5ka.ru
kp=HQ Trivia
dt=Delivery Club
ya=Yandex
ya=Yandex call forwarding
mt=Steam
oi=Tinder
fd=Mamba
zz=DENT
kt=KakaoTalk
pm=AOL
tn=LinkedIN
qq=Tencent QQ
mg=Magnit
pf=pof.com
yl=Yalla
kl=kolesa.kz
po=premium.one
nv=Naver
nf=Netflix
iq=icq
ob=Onlinerby
kb=kufarby
im=Imo
mc=Michat
ds=Discord
vv=Seosprint
ji=Monobank
lf=TikTok/Douyin
hu=Ukrnet
wg=Skout
rz=EasyPay
vf=Q12 Trivia
ny=Pyro Music
rr=Wolt
fe=CliQQ
la=ssoidnet
zh=Zoho
gp=Ticketmaster
am=Amazon
ly=Olacabs
tc=Rambler
dp=ProtonMail
pg=NRJ Music Awards
yf=Citymobil
op=MIRATORG
fx=PGbonus
qr=MEGA
yk=СпортМастер
ls=Careem
bl=BIGO LIVE
mu=MyMusicTaste
fu=Snapchat
bf=Keybase
sg=OZON
uu=Wildberries
ua=BlaBlaCar
ab=Alibaba
iv=Inboxlv
zy=Nttgame
gd=Surveytime
fy=Mylove
ce=mosru
tl=Truecaller
hm=Globus
tx=Bolt
ka=Shopee
pl=Перекресток
ip=Burger King
cm=Prom
hw=AliPay
de=Karusel
jc=IVI
rl=inDriver
df=Happn
ui=RuTube
up=Magnolia
nz=Foodpanda
kf=Weibo
ri=BillMill
cc=Quipp
lr=Okta
za=JDcom
da=MTS CashBack
ug=Fiqsy
sq=KuCoinPlay
zr=Papara
xv=Wish
cx=Icrypex
cw=PaddyPower
li=Baidu
dz=Dominos Pizza
xz=paycell
rd=Lenta
qb=Payberry
hz=Drom
gl=GlobalTel
zk=Deliveroo
ia=Socios
xl=Wmaraci
yi=Yemeksepeti
ew=Nike
ae=myGLO
gb=YouStar
cy=РСА
qm=RosaKhutor
dh=eBay
yb=Система Город
qe=GG
yw=Grindr
uz=OffGamers
gx=Hepsiburadacom
re=Coinbase
tj=dbrUA
ts=PayPal
rt=hily
sf=SneakersnStuff
sv=Dostavista
qi=32red
bz=Blizzard
db=ezbuy
vw=CoinField
zl=Airtel
wf=YandexGo
lw=MrGreen
co=Rediffmail
ey=miloan
ge=Paytm
os=Dhani
ql=CMTcuzdan
cq=Mercado
xk=DiDi
py=Monese
rv=Kotak811
jl=Hopi
pr=Trendyol
pu=Justdating
dk=Pairs
fm=Touchance
ph=SnappFood
sw=NCsoft
nr=Tosla
hy=Ininal
tr=Paysend
pq=CDkeys
ff=AVON
sd=dodopizza
ry=McDonalds
le=E bike Gewinnspiel
hr=JKF
qa=MyFishka
wc=Craigslist
kw=Foody
jg=Grab
mj=Zalo
eu=LiveScore
ll=888casino
ed=Gamer
pp=Huya
th=WestStein
xr=Tango
iz=Global24
tk=МВидео
rx=Sheerid
ki=99app
my=CAIXA
zm=OfferUp
tq=Swvl
au=Haraj
ei=Taksheel
rp=hamrahaval
pa=Gamekit
fs= Şikayet var
ul=Getir
cf=irancell
bt=Alfa
ud=Disney Hotstar
qu=Agroinform
un=humblebundle
rm=Faberlic
uo=CafeBazaar
ti=cryptocom
nk=Gittigidiyor
jm=mzadqatar
lp=Algida
si=Cita Previa
fj=Potato Chat
pt=Bitaqaty
qc=Праймериз 2020
yo=Amasia
fx=PGbonus call forwarding
ve=Dream11
qh=Oriflame
iu=Bykea
ib=Immowelt
zv=Digikala
jb=Wing Money
vn=Yaay
wn=GameArena
bj=Вита экспресс
st=Auchan
ev=Picpay
qn=Blued
cd=SpotHit
vo=Brand20ua
il=IQOS
dx=Powerkredite
el=Bisu
dn=Paxful
lk=PurePlatfrom
vc=Banqi
wj=1хbet
wk=Mobile01
jj=Aitu
an=Adidas
jr=Самокат
nb=Верный
gv=Humta
dw=Divar
gj=Carousell
hc=MOMO
uf=Eneba
kn=Verse
qd=Taobao
hn=1688
zf=OnTaxi
gi=Hotline
uc=Tatneft
mn=RRSA
ak=Douyu
cp=Uklon
qo=Moneylion
wx=Apple
et=Clubhouse
px=Nifty
jh=PingPong
lb=Mailru Group
lt=BitClout
sk=Skroutz
oh=MapleSEA
km=Rozetka
af=GalaxyWin
tt=Ziglu
jf=Likee
az=CityBase
yn=Allegro
wl=YouGotaGift
dl=Lazada
gc=TradingView
cn=Fiverr
ou=Gabi
vp=Kwai
rj=Детский мир
uh=Yubo
es=iQIYI
be=goods
aq=Glovo
pd=IFood
zw=Quack
gm=Mocospace
fi=Dundle
hg=Switips
qz=Faceit
gz=LYKA
jq=Paysafecard
ue=Onet
xf=LightChat
bp=GoFundMe
vy=Meta
ea=JamesDelivery
hj=Stoloto
sh=Vkusvill
vg=ShellBox
qf=RedBook
nq=Trip
ww=BIP
ke=Эльдорадо
qj=Whoosh
ol=KazanExpress
tm=Akulaku
ra=KeyPay
xj=СберМаркет
vd=Betfair
ni=Gojek
mr=Fastmail
hx=AliExpress
bv=Metro
sj=HandyPick
td=ChaingeFinance
dm=Iwplay
xs=GroupMe
kz=NimoTV
nu=Stripe
kr=Eyecon
pz=Lidl
hb=Twitch
xe=GalaxyChat
io=ЗдравСити
ad=Iti
zg=Setel
ij=Revolut
sl=СберАптека
wp=163СOM
en=Hermes
zo=Kaggle
vx=HeyBox
hl=Band
lq=Potato
uj=СhampionСasino
ga=Roposo
bo=Wise
fz=KFC
vm=OkCupid
ch=Pocket52
yp=Payzapp
cs=AgriDevelop
yg=CourseHero
lj=Santander
oz=Poshmark
wh=TanTan
wt=IZI
og=Okko
xq=MPL
xh=OVO
kc=Vinted
hk=4Fun
yz=Около
eo=Sizeer
ft=Букмекерские
tf=Noon
lv=WinZO
dy=Zomato
lx=DewuPoison
nn=Giftcloud
zs=Bilibili
kx=Vivo
ee=Twilio
tp=Mr Green
ku=RoyalWin
ot=Any other
